//MAP CONVERTED BY dmm2tgm.py THIS HEADER COMMENT PREVENTS RECONVERSION, DO NOT REMOVE
"a" = (
/turf/open/space/bluespace,
/area/hilbertshotel)
"b" = (
/turf/closed/wall/mineral/brick,
/area/hilbertshotel)
"c" = (
/turf/open/floor/wood_common/wood_common_dark,
/area/hilbertshotel)
"d" = (
/obj/machinery/light{
	dir = 1
	},
/turf/open/floor/wood_common/wood_common_dark,
/area/hilbertshotel)
"e" = (
/turf/closed/indestructible/hoteldoor,
/area/hilbertshotel)
"f" = (
/obj/structure/simple_door/twowide_example{
	dir = 1
	},
/turf/open/floor/wood_common/wood_common_dark,
/area/hilbertshotel)
"g" = (
/obj/structure/mirror/alt{
	pixel_x = 32
	},
/turf/open/floor/plasteel/freezer{
	name = "tile floor"
	},
/area/hilbertshotel)
"j" = (
/obj/machinery/shower{
	pixel_y = 22
	},
/turf/open/floor/plasteel/freezer{
	name = "tile floor"
	},
/area/hilbertshotel)
"l" = (
/obj/structure/chair/sofa{
	dir = 1
	},
/turf/open/floor/wood_common/wood_common_dark,
/area/hilbertshotel)
"m" = (
/obj/structure/decoration/vent,
/turf/open/floor/plasteel/freezer{
	name = "tile floor"
	},
/area/hilbertshotel)
"o" = (
/obj/machinery/light,
/obj/structure/chair/sofa/left{
	dir = 1
	},
/turf/open/floor/wood_common/wood_common_dark,
/area/hilbertshotel)
"p" = (
/obj/machinery/light{
	dir = 8
	},
/turf/open/floor/wood_common/wood_common_dark,
/area/hilbertshotel)
"q" = (
/obj/structure/closet/cabinet/anchored,
/turf/open/floor/wood_common/wood_common_dark,
/area/hilbertshotel)
"r" = (
/obj/effect/particle_effect/steam,
/obj/effect/overlay/fog/fog3,
/turf/open/water,
/area/hilbertshotel)
"s" = (
/obj/machinery/light{
	dir = 4
	},
/turf/open/floor/wood_common/wood_common_dark,
/area/hilbertshotel)
"t" = (
/obj/structure/simple_door/twowide_example{
	dir = 1;
	name = "wide door"
	},
/turf/open/floor/wood_common/wood_common_dark,
/area/hilbertshotel)
"u" = (
/obj/machinery/light,
/turf/open/floor/plasteel/freezer{
	name = "tile floor"
	},
/area/hilbertshotel)
"v" = (
/obj/structure/bed/double/huge,
/obj/item/bedsheet/huge/doublesheet,
/turf/open/floor/wood_common/wood_common_dark,
/area/hilbertshotel)
"x" = (
/obj/machinery/light{
	dir = 8
	},
/turf/open/floor/plasteel/freezer{
	name = "tile floor"
	},
/area/hilbertshotel)
"z" = (
/obj/structure/chair/sofa/right{
	dir = 1
	},
/turf/open/floor/wood_common/wood_common_dark,
/area/hilbertshotel)
"D" = (
/obj/machinery/light{
	dir = 4
	},
/turf/open/floor/plasteel/freezer{
	name = "tile floor"
	},
/area/hilbertshotel)
"F" = (
/obj/structure/window/reinforced/survival_pod,
/obj/machinery/shower{
	dir = 1;
	pixel_y = 7
	},
/turf/open/floor/plasteel/freezer{
	name = "tile floor"
	},
/area/hilbertshotel)
"G" = (
/obj/structure/table/glass,
/obj/item/reagent_containers/rag/towel,
/obj/item/reagent_containers/rag/towel{
	pixel_y = 6
	},
/obj/item/soap/deluxe,
/turf/open/floor/plasteel/freezer{
	name = "tile floor"
	},
/area/hilbertshotel)
"H" = (
/turf/open/floor/plasteel/freezer{
	name = "tile floor"
	},
/area/hilbertshotel)
"I" = (
/obj/structure/table/wood/fancy/royalblack,
/obj/item/flashlight/lamp/green,
/turf/open/floor/wood_common/wood_common_dark,
/area/hilbertshotel)
"J" = (
/obj/structure/fireplace,
/turf/open/floor/wood_common/wood_common_dark,
/area/hilbertshotel)
"M" = (
/obj/structure/closet/crate/wooden,
/obj/item/stack/sheet/mineral/wood/fifty,
/obj/item/stack/sheet/mineral/wood/fifty,
/obj/item/lighter/iconic,
/turf/open/floor/wood_common/wood_common_dark,
/area/hilbertshotel)
"N" = (
/obj/structure/toilet{
	dir = 8
	},
/turf/open/floor/plasteel/freezer{
	name = "tile floor"
	},
/area/hilbertshotel)
"Q" = (
/obj/machinery/telecomms/relay/preset/auto,
/turf/open/floor/wood_common/wood_common_dark,
/area/hilbertshotel)
"R" = (
/obj/structure/dresser,
/turf/open/floor/wood_common/wood_common_dark,
/area/hilbertshotel)
"S" = (
/obj/structure/sink{
	dir = 4;
	pixel_x = 11
	},
/turf/open/floor/plasteel/freezer{
	name = "tile floor"
	},
/area/hilbertshotel)
"T" = (
/obj/machinery/door/window/right{
	dir = 2
	},
/turf/open/floor/plasteel/freezer{
	name = "tile floor"
	},
/area/hilbertshotel)
"X" = (
/turf/open/space/bluespace,
/area/space)
"Y" = (
/obj/machinery/light{
	dir = 8
	},
/obj/effect/particle_effect/steam,
/obj/effect/overlay/fog/fog3,
/turf/open/water,
/area/hilbertshotel)

(1,1,1) = {"
Q
a
a
a
a
a
a
a
a
a
a
a
a
a
a
a
"}
(2,1,1) = {"
X
a
b
b
b
b
b
e
b
b
b
b
b
b
b
a
"}
(3,1,1) = {"
X
a
b
I
c
c
c
c
c
p
H
r
r
Y
b
a
"}
(4,1,1) = {"
X
a
b
c
c
c
c
c
c
c
H
r
r
r
b
a
"}
(5,1,1) = {"
X
a
b
c
c
c
c
c
c
c
H
r
r
r
b
a
"}
(6,1,1) = {"
X
a
b
c
c
c
c
c
c
c
H
H
H
H
b
a
"}
(7,1,1) = {"
X
a
b
c
c
v
c
c
c
c
c
c
c
c
b
a
"}
(8,1,1) = {"
X
a
b
I
c
c
c
c
c
s
c
c
c
s
b
a
"}
(9,1,1) = {"
X
a
b
b
b
b
b
c
t
b
c
f
b
b
b
a
"}
(10,1,1) = {"
X
a
b
j
x
F
G
H
H
b
c
c
R
q
b
a
"}
(11,1,1) = {"
X
a
b
j
m
F
G
H
H
b
c
c
c
c
b
a
"}
(12,1,1) = {"
X
a
b
j
H
T
H
H
u
b
d
c
c
o
b
a
"}
(13,1,1) = {"
X
a
b
j
m
F
H
H
H
b
J
c
c
l
b
a
"}
(14,1,1) = {"
X
a
b
j
D
F
S
g
N
b
M
c
c
z
b
a
"}
(15,1,1) = {"
X
a
b
b
b
b
b
b
b
b
b
b
b
b
b
a
"}
(16,1,1) = {"
X
a
a
a
a
a
a
a
a
a
a
a
a
a
a
a
"}
