//MAP CONVERTED BY dmm2tgm.py THIS HEADER COMMENT PREVENTS RECONVERSION, DO NOT REMOVE
"a" = (
/turf/open/floor/grass/snow,
/area/hilbertshotel)
"b" = (
/obj/structure/barricade/tentclothedge{
	pixel_y = 4
	},
/turf/open/floor/plating/ice,
/area/hilbertshotel)
"d" = (
/obj/structure/simple_door/tentflap_cloth{
	pixel_y = 4
	},
/turf/open/floor/plating/ice,
/area/hilbertshotel)
"e" = (
/obj/structure/fireplace,
/turf/open/floor/wood_worn/wood_worn_dark,
/area/hilbertshotel)
"g" = (
/obj/structure/window/fulltile/civ/nordic_window,
/obj/structure/curtain/directional/north,
/turf/open/floor/wood_worn/wood_worn_dark,
/area/hilbertshotel)
"i" = (
/obj/structure/barricade/tentclothcorner{
	dir = 1
	},
/turf/open/floor/plating/ice,
/area/hilbertshotel)
"j" = (
/obj/structure/table/wood/settler,
/turf/open/floor/wood_worn/wood_worn_dark,
/area/hilbertshotel)
"k" = (
/turf/closed/indestructible/f13/matrix,
/area/hilbertshotel)
"m" = (
/obj/structure/chair/stool/retro/tan,
/turf/open/floor/plating/ice,
/area/hilbertshotel)
"o" = (
/turf/open/floor/plating/beach/water,
/area/hilbertshotel)
"p" = (
/obj/structure/flora/brushwoodalt,
/turf/closed/indestructible/f13/matrix,
/area/hilbertshotel)
"r" = (
/obj/structure/barricade/tentclothcorner{
	pixel_y = 5
	},
/turf/open/floor/plating/ice,
/area/hilbertshotel)
"s" = (
/turf/closed/wall/f13/wood,
/area/hilbertshotel)
"v" = (
/obj/structure/barricade/tentclothcorner{
	dir = 4;
	pixel_y = 4
	},
/turf/open/floor/plating/ice,
/area/hilbertshotel)
"x" = (
/obj/structure/bed/double,
/obj/item/bedsheet/doublesheetbrown,
/turf/open/floor/wood_worn/wood_worn_dark,
/area/hilbertshotel)
"y" = (
/turf/open/floor/plating/ice,
/area/hilbertshotel)
"z" = (
/turf/closed/indestructible/hoteldoor{
	icon_state = "door_closed";
	icon = 'icons/obj/doors/puzzledoor/default.dmi'
	},
/area/hilbertshotel)
"B" = (
/obj/structure/barricade/tentclothedge{
	dir = 1;
	pixel_y = -4
	},
/turf/open/floor/plating/ice,
/area/hilbertshotel)
"C" = (
/obj/structure/barricade/tentclothedge{
	dir = 4;
	pixel_y = 4;
	pixel_x = 4
	},
/turf/open/floor/plating/ice,
/area/hilbertshotel)
"E" = (
/turf/open/floor/wood_worn/wood_worn_dark,
/area/hilbertshotel)
"F" = (
/turf/open/indestructible/ground/outside/savannah,
/area/hilbertshotel)
"G" = (
/obj/machinery/microwave/stove,
/turf/open/floor/wood_worn/wood_worn_dark,
/area/hilbertshotel)
"H" = (
/obj/structure/table/wood/settler,
/obj/item/storage/box/matches,
/turf/open/floor/wood_worn/wood_worn_dark,
/area/hilbertshotel)
"I" = (
/obj/effect/sound_emitter/foxybar/windycurtains,
/turf/open/floor/grass/snow,
/area/hilbertshotel)
"J" = (
/obj/structure/barricade/tentclothedge{
	dir = 4;
	pixel_x = -2
	},
/turf/open/floor/plating/ice,
/area/hilbertshotel)
"M" = (
/obj/structure/dresser,
/turf/open/floor/wood_worn/wood_worn_dark,
/area/hilbertshotel)
"N" = (
/obj/effect/sound_emitter/foxybar/windycurtains,
/turf/open/indestructible/ground/outside/savannah,
/area/hilbertshotel)
"O" = (
/obj/structure/simple_door/wood,
/turf/open/floor/wood_worn/wood_worn_dark,
/area/hilbertshotel)
"P" = (
/obj/structure/flora/tallgrass6,
/turf/open/floor/grass/snow,
/area/hilbertshotel)
"Q" = (
/obj/structure/chair/stool/retro/tan,
/obj/item/fishingrod,
/turf/open/floor/plating/ice,
/area/hilbertshotel)
"S" = (
/obj/structure/barricade/tentclothcorner{
	dir = 8
	},
/turf/open/floor/plating/ice,
/area/hilbertshotel)
"U" = (
/obj/structure/flora/branch_broken,
/turf/open/floor/grass/snow,
/area/hilbertshotel)
"V" = (
/obj/structure/rug/big/rug_red{
	pixel_x = -16;
	pixel_y = -7
	},
/turf/open/floor/wood_worn/wood_worn_dark,
/area/hilbertshotel)
"W" = (
/obj/structure/flora/tree/pine,
/turf/open/floor/grass/snow,
/area/hilbertshotel)
"Y" = (
/obj/item/stack/sheet/mineral/wood/fifty,
/obj/item/stack/sheet/mineral/wood/fifty,
/obj/item/stack/sheet/mineral/wood/fifty,
/turf/open/floor/wood_worn/wood_worn_dark,
/area/hilbertshotel)
"Z" = (
/obj/structure/table/wood/settler,
/obj/item/melee/onehanded/knife/hunting,
/turf/open/floor/wood_worn/wood_worn_dark,
/area/hilbertshotel)

(1,1,1) = {"
k
k
k
k
k
k
k
z
k
k
k
k
k
k
k
k
"}
(2,1,1) = {"
k
a
a
a
a
a
P
F
a
y
i
C
C
v
a
k
"}
(3,1,1) = {"
k
a
a
a
W
a
a
F
a
y
B
m
y
d
F
k
"}
(4,1,1) = {"
k
a
a
a
a
U
a
N
a
y
B
Q
o
b
F
k
"}
(5,1,1) = {"
k
a
P
a
a
W
a
F
a
y
S
J
J
r
F
k
"}
(6,1,1) = {"
k
a
a
a
a
a
a
F
a
y
y
y
y
y
F
k
"}
(7,1,1) = {"
k
a
a
W
a
a
a
F
P
y
y
y
y
y
F
k
"}
(8,1,1) = {"
k
a
a
a
a
a
a
F
a
y
y
y
y
y
F
k
"}
(9,1,1) = {"
k
s
s
s
s
s
s
F
a
W
a
y
y
y
F
k
"}
(10,1,1) = {"
k
s
j
H
G
E
g
F
a
a
a
a
F
F
F
k
"}
(11,1,1) = {"
k
s
Z
E
E
E
g
F
P
a
a
W
F
I
a
k
"}
(12,1,1) = {"
k
s
M
Y
E
E
O
F
F
a
a
a
F
a
P
k
"}
(13,1,1) = {"
k
s
s
e
V
E
g
a
F
F
F
F
F
a
a
k
"}
(14,1,1) = {"
k
s
x
E
E
E
g
a
a
a
W
a
a
W
a
k
"}
(15,1,1) = {"
k
s
s
s
s
s
s
a
a
a
a
P
a
a
a
k
"}
(16,1,1) = {"
k
k
k
k
k
k
k
k
p
k
k
k
k
k
k
k
"}
